NO ./assets/north.xpm
EA ./assets/east.xpm

SO ./assets/south.xpm

F  17,17,40
WE ./assets/west.xpm
C  105,65,192


11111111111 1111111111111
10000100001 1000000000111
10111100001111C1110100001
1100C00000000000000C0011
10111110001100000001000011
11     1000N000000000000011
101 1110001100000001000011
101100000111000000001001
100100000000001000000001
111111111111101111111111
111111111111111111111111

