WE ./textures/wall_1.xpm
EA ./textures/wall_2.xpm
NO ./textures/wall_3.xpm
SO ./textures/wall_4.xpm

C 0,0,0
F 0,0,0


1111
1W1
1111