WE ./textures/wall_1.xpm
EA ./textures/wall_2.xpm
NO ./textures/wall_3.xpm
SO ./textures/wall_4.xpm

C 0,0,0
F 0,0,0


111101111111111111
1000000000011110001
100000000001  10001
10000000001    10001
10000000001    10001
10000000001    10001
10000000000111100001
11C100000E0000000001
10010000000000000001
10010000000000000001
11111111111111111111