WE ./textures/12.xpm
EA ./textures/11.xpm
NO ./textures/13.xpm
SO ./textures/14.xpm

C 0,0,0
F 0,0,0


11111111111111111111
10000000000000000001
10000000000000000001
10000000000000000001
11C100000E0000000001
10010000000000000001
10010000000000000001
11111111111111111111
