NO textures/frieren_3_(1).xpm





SO textures/frieren_3_(1).xpm
C 250,0,0
WE textures/frieren_3_(1).xpm
EA textures/frieren_3_(1).xpm




F 220,100,0












1111111111111111111111111111
100000000011000000000000111111
10110000011100000000000011111
100100000000000000000000111111111
111111111011000001110000000000001
100000000011000001110111111111111
111101111111110111000000100011
11110111111111011101010010001
110000001111010111000000100011
10000000000000001100000010001
10000000000000000001010010001
10000000000000001101010010001
10000000000000001100000010001
10000000000000001101010010001
10000000000000000001010010001
10000000000000001101010010001
10000000000000001100000010001
10000000000000001101010010001
10000000000000001100000010001
10000000000000000001010010001
10000000000000001101010010001
10000000000000001100000010001
10000000000000001101010010001
10000000000000000001010010001
10000000000000001101010010001
10000000000000001100000010001
10000000000000001101010010001
10000000000000001100000010001
10000000000000000001010010001
10000000000000001101010010001
10000000000000001100000010001
10000000000000001101010010001
10000000000000000001010010001
10000000000000001101010010001
10000000000000001100000010001
10000000000000001101010010001
10000000000000001100000010001
10000000000000000001010010001
10000000000000001101010010001
10000000000000001100000010001
10000000000000001101010010001
10000000000000000001010010001
10000000000000001101010010001
10000000000000001100000010001
10000000000000001101010010001
10000000000000001100000010001
10000000000000000001010010001
10000000000000001101010010001
10000000000000001100000010001
10000000000000001101010010001
10000000000000000001010010001
10000000000000001101010010001
10000000000000001100000010001
10000000000000001101010010001
10000000000000001100000010001
10000000000000000001010010001
10000000000000001101010010001
10000000000000001100000010001
10000000000000001101010010001
10000000000000000001010010001
10000000000000001101010010001
10000000000000001100000010001
10000000000000001101010010001
10000000000000001100000010001
10000000000000000001010010001
10000000000000001101010010001
10000000000000001100000010001
10000000000000001101010010001
10000000000000000001010010001
10000000000000001101010010001
10000000000000001100000010001
10000000000000001101010010001
10000000000000001100000010001
10000000000000000001010010001
10000000000000001101010010001
10000000000000001100000010001
10000000000000001101010010001
10000000000000000001010010001
10000000000000001101010010001
10000000000000001100000010001
10000000000000001101010010001
10000000000000001100000010001
10000000000000000001010010001
10000000000000001101010010001
10000000000000001100000010001
10000000000000001101010010001
10000000000000000001010010001
10000000000000001101010010001
10000000000000001100000010001
10000000000000001101010010001
10000000000000001100000010001
10000000000000000001010010001
10000000000000001101010010001
10000000000000001100000010001
10000000000000001101010010001
10000000000000000001010010001
10000000000000001101010010001
10000000000000001100000010001
10000000000000001101010010001
10000000000000001100000010001
10000000000000000001010010001
10000000000000001101010010001
10000000000000001100000010001
10000000000000001101010010001
10000000000000000001010010001
10000000000000001101010010001
10000000000000001100000010001
10000000000000001101010010001
10000000000000001100000010001
10000000000000000001010010001
10000000000000001101010010001
10000000000000001100000010001
10000000000000001101010010001
10000000000000000001010010001
10000000000000001101010010001
10000000000000001100000010001
10000000000000001101010010001
10000000000000001100000010001
10000000000000000001010010001
10000000000000001101010010001
10000000000000001100000010001
10000000000000001101010010001
10000000000000000001010010001
10000000000000001101010010001
10000000000000001100000010001
10000000000000001101010010001
10000000000000001100000010001
1C0000000C0000000C01010010001
10000000000000001101010010001
1000000N000000001100000010001
10000000000000001101010010001
10000000000000000001010010001
10000000000000001101010010001
10000000000000001100000010001
10000000000000001101010010001
1100000111010101111101111000111
111100000111111101011101111011
11111111111111111111111111111
